# # . . # . # . # . 
# . # # # # . . . . 
. # # . . . . . # . 
. . . # # # # # . . 
# # . # . # . . . . 
. # # # # . . # . . 
# . # . . # # # # # 
# # # . . . . . . # 
# # # . . . # # # # 
# . # # . . . # . . 
